****i
****o
*o***
@o#**
*ooo*
*****
**$**

#**x*
*ooo*
*****
**@**
*****
*ooo*
*x**$

@*oix
*****
***o*
**$**
*o***
*****
xio*#

x*x*x
*****
*i**$
*oooo
****#
*****
x***@

@*x*#
***o*
*o$x*
**x*o
**o**
o****
ix***

